activatecpptrigger=Activate CPP Trigger
airbubbles=Air Bubbles
alphalerplightsources=Alpha Lerp Light Sources
angrykevin=Angry Kevin
anxietyeffect=Anxiety Effect
anxietyorigin=Anxiety Origin
anxietytrigger=Anxiety Trigger
betterridgegate=Better Ridge Gate
bgtoggle=Bg Toggle
bhlboss=BHL Boss
bhlfeather=BHL Feather
bloomrenderermodifier=Bloom Renderer Modifier
brokemiafloatierspaceblock=Floatier Space Block
burstattacher=Burst Attacher
burstcontrollers=Burst Controllers
bursteffects=Burst Effects
burstremover=Burst Remover
burstzone=Burst Zone
cassettemover=Cassette Mover
cassettespikes=Cassette Spikes
changespawntoclosest=Change Spawn To Closest
circularresortplatform=Circular Resort Platform
clearpipe=Clear Pipe
coloredbigwaterfall=Colored Big Waterfall
coloreddustsprite=Colored Dust Sprite
coloredhanginglampofcolorfulness=Colored Hanging Lamp
coloredwater=Colored Water
coloredwaterfall=Colored Waterfall
colorlerplightsources=Color Lerp Light Sources
confetticontrollers=Confetti Controllers
confettispawnattacher=Confetti Spawn Attacher
confettispawner=Confetti Spawner
confettispawnzone=Confetti Spawn Zone
coreberry=Core Berry
customclutter=Custom Clutter
customconfetti=Custom Confetti
customcrumble=Custom Crumble
customdust=Custom Dust
customeffect=Custom Effect
customfield=Custom Field
customfirebarrier=Custom Fire Barrier
customflutterbird=Custom Flutterbird
custominteractions=Custom Interactions
custompoem=Custom Poem
customrefill=Custom Refill
customsatellite=Custom Satellite
customspacejam=Custom Space Jam
customspring=Custom Spring
customzipmover=Custom Zip Mover
dashtoggleblock=Dash Toggle Block
dashwaterswitch=Dash Water Switch
deathlboss=Death L Boss
deathlfeather=Death L Feather
dreamdashcontroller=Dream Dash Controller
drivablecar=Drivable Car
effectparameters=Effect Parameters
entityactivator=Entity Activator
entitymover=Entity Mover
fakespikes=Fake Spikes
fallingblock=Falling Block
fancyconditionblock=Fancy Condition Block
fancycoverupwall=Fancy Coverup Wall
fancycrumblewallonrumble=Fancy Crumble Wall On Rumble
fancydashblock=Fancy Dash Block
fancyexitblock=Fancy Exit Block
fancyfakewall=Fancy Fake Wall
fancyfallingblock=Fancy Falling Block
fancyfinalbossmovingblock=Fancy Final Boss Moving Block
fancyfloatyspaceblock=Fancy Floaty Space Block
fancyintrocrusher=Fancy Intro Crusher
fancyridgegate=Fancy Ridge Gate
fancysolidtiles=Fancy Solid Tiles
flagtoggleswitch=Flag Toggle Switch
flickerlightsources=Flicker Light Sources
forcedfastfalltrigger=Forced Fastfall Trigger
ftcutscenetrigger=Cutscene Trigger
ftsnowstormtrigger=Snowstorm Trigger
gauntletgate=Gauntlet Gate
glitcheffect=Glitch Effect
goldenberrygate=Golden Berry Gate
heartboss=Heart Boss
highresolutionparticle=High Resolution Particle
horizontalwaterfall=Horizontal Waterfall
icecycle=Icicle
invisiblelightsource=Invisible Light Source
laseremitter=Laser Emitter
lasermirror=Laser Mirror
lasernoteblock=Laser Note Block
lasersensor=Laser Sensor
laservalve=Laser Valve
lightningstrike=Lightning Strike
lightningstrikes=Lightning Strikes
lightoccludezone=Light Occlude Zone
lightsource=Light Source
lightsources=Light Sources
lightsourcezone=Light Source Zone
luacutscenetrigger=Lua Cutscene Trigger
luatalker=Lua Talker
madelinespotlightmodifier=Madeline Spotlight Modifier
marioshell=Mario Shell
mdmaxdashes=Max Dashes
momentummodifier=Momentum Modifier
monumentbooster=Monument Booster
monumentflipswitch=Monument Flip Switch
monumentpressureplate=Monument Pressure Plate
monumentspikes=Monument Spikes
monumentswapblock=Monument Swap Block
monumentswitchblock=Monument Switch Block
mycoloredwater=My Colored Water
mycoloredwaterfall=My Colored Waterfall
nodasharea=No Dash Area
pandorasbox=Pandora's Box
plusonerefill=Plus One Refill
propellerbox=Propeller Box
raincloud=Rain Cloud
randomsound=Random Sound
rcsparticlecounttrigger=RCS Particle Count Trigger
rcsparticledecrease=RCS Particle Decrease
santaarefill=Santa Refill
screenwipe=Screen Wipe
slowkevin=Slow Kevin
sociopathy=Item Toggle Trigger
spawsteamwalltrigger=Spawn Steam Wall Trigger
staticbumper=Static Bumper
staticspikes=Static Spikes
strawberrygate=Strawberry Gate
strawberrywithreturn=Strawberry With Return
switchtrigger=Switch Trigger
teleportationtarget=Teleportation Target
tileglitcher=Tile Glitcher
timefield=Time Field
toggleswapblock=Toggle Swap Block
vortexcustombumper=Custom Bumper
waterdrowncontroller=Water Drown Controller
waterpaintball=Water Paintball
yourmom=Desert Trigger
